[][][][][][][][][][][]
[][][][][][][]//    []
[][][][][][][]//[]  []
[][][][][][][]//[]  []
[]  :)  ()  ()  ()  []
[]  []  []  []  [][][]
[]              [][][]
[][][][][][][][][][][]
