[][][][][][][][]
[][][]  ////:)[]
[][][]  ()()  []
[][][][]  [][][]
[][][][]  [][][]
[][][][]  [][][]
[][][][]  [][][]
[]        [][][]
[]  []      [][]
[]      []  [][]
[][][]      [][]
[][][][][][][][]
