[][][][][][]
[]//    [][]
[]:)()()  []
[][]      []
[][][]    []
[][][][]//[]
[][][][][][]
