[][][][][][][][][]
[]:)      \/\///[]
[]  ()  ()  \/  []
[]    ()    \/  []
[][][][][][][][][]
