[][][][][][]
[]  //[][][]
[]    [][][]
[]{}:)    []
[]    ()  []
[]    [][][]
[][][][][][]
