[][][][][][][][]
[]    []  []//[]
[]  ()  []  [][]
[]    []  []  []
[]:)    []  [][]
[][][][][][][][]

w  0 -1
a -1  0
s  0  1
d  1  0
q -1 -1
e  1 -1
z -1  1
c  1  1
