[][][][][][][][][][][][]
[]        [][][]      []
[]  ()()          []:)[]
[]  ()  []//////      []
[]      [][][][][][][][]
[][][][][][][][][][][][]
