[][][][][][][][][]
[][][]    [][][][]
[]          ()  []
[]  []    []()  []
[]  //  //[]:)  []
[][][][][][][][][]
