[][][][][][][][]
[]            []
[]  //{}{}():)[]
[]            []
[][][][][]    []
[][][][][][][][]
