[][][][][][][][]
[][]          []
[][]  //()//  []
[][]  ():)()  []
[]    //()//  []
[]            []
[][][][][][][][]
