[][][][][][]
[]        []
[]  []:)  []
[]  (){}  []
[]  //{}  []
[]        []
[][][][][][]
